1111111111111
10000C0000001
1000CPC000001
10000C0E00001
1000000000001
1111111111111