1111111111111
1000000000001
1001110000001
10000000C0001
1001110000001
1000000000001
1001110000001
1PC110C000E01
1111111111111