1111111111111
1000000000001
1001110000001
1P01100C00E01
1111111111111