1111111111111
1000000000001
1001110000001
1000000000001
1001110000001
1000000000001
1001110000001
1PC1100000E01
1111111111111