1111111111111
1001000000CC1
1000011111001
1P0011010E001
1111111111111